z, v = vậy 
face = mặt
mng,mn = mọi người
loz, lón, l, lon, cl, lìn = 
cđ, cdi,condi, đũy, cđl = con đĩ 
ko, khum, k, hok, hong, hôn, kg = không
sì tai lít , sai lích, sờ tai lích = stylish
bík = biết
nch = nói chuyện 
chos = chó
HHHV = hoa hậu hoàn vũ
đc, dc = được 
kp = không phải
b = bạn
rui, r, òi, rùi, gòi = rồi
vs = với
ms = mới
lm = làm
ng ta = người ta
c = chị
cg = cũng
e = em
cll mm = thua :)
ngoo = ngu
th = thằng
đjtme = 
i, ik = đi
ava = avatar
đin = điên
nungl, nl = 
mé = má
condime
cc
nx = nữa
yanglake
thui = thôi
fai = phải
trk, trc = trước
lm = làm
xh = xã hội
HH = hoa hậu
đụ mạ
đhs = đ hiểu sao
clg = 
đou má
vlin
fk = phải không
đg = đường
cg = cũng
khùm = khùng